Name                                  	Type       File
605790                                	Instance   instances\605790.fsh
605791                                	Instance   instances\605791.fsh
AppointmentMutabilityExtension        	Extension  extensions\AppointmentMutabilityExtension.fsh
ChildAppointment                      	Extension  extensions\ChildAppointment.fsh
FinnishAppointmentAppointment         	Profile    profiles\FinnishAppointmentAppointment.fsh
FinnishAppointmentHealthcareService   	Profile    profiles\FinnishAppointmentHealthcareService.fsh
FinnishAppointmentLocation            	Profile    profiles\FinnishAppointmentLocation.fsh
FinnishAppointmentPatient             	Profile    profiles\FinnishAppointmentPatient.fsh
FinnishAppointmentPractitioner        	Profile    profiles\FinnishAppointmentPractitioner.fsh
FinnishAppointmentSchedule            	Profile    profiles\FinnishAppointmentSchedule.fsh
FinnishAppointmentSlot                	Profile    profiles\FinnishAppointmentSlot.fsh
GOFSH-GENERATED-ID-0                  	Instance   instances\GOFSH-GENERATED-ID-0.fsh
GOFSH-GENERATED-ID-1                  	Instance   instances\GOFSH-GENERATED-ID-1.fsh
HomeMunicipalityExtension             	Extension  extensions\HomeMunicipalityExtension.fsh
NotificationInfoExtension             	Extension  extensions\NotificationInfoExtension.fsh
ParentAppointment                     	Extension  extensions\ParentAppointment.fsh
PatientInstructionURLExtension        	Extension  extensions\PatientInstructionURLExtension.fsh
app-4                                 	Invariant  invariants\app-4.fsh
ef19597b-623d-4453-9f62-bc06de64e9c8  	Instance   instances\ef19597b-623d-4453-9f62-bc06de64e9c8.fsh
AdditionalInformationURLExtension   	Extension  extensions\AdditionalInformationURLExtension.fsh
AppointmentMutabilityExtension      	Extension  extensions\AppointmentMutabilityExtension.fsh
CareGuaranteeExtension              	Extension  extensions\CareGuaranteeExtension.fsh
CareplanIdentifierExtension         	Extension  extensions\CareplanIdentifierExtension.fsh
CustomerJourneyExtension            	Extension  extensions\CustomerJourneyExtension.fsh
FinnishSchedulingAppointment        	Profile    profiles\FinnishSchedulingAppointment.fsh
FinnishSchedulingHealthcareService  	Profile    profiles\FinnishSchedulingHealthcareService.fsh
FinnishSchedulingLocation           	Profile    profiles\FinnishSchedulingLocation.fsh
FinnishSchedulingPatient            	Profile    profiles\FinnishSchedulingPatient.fsh
FinnishSchedulingPractitioner       	Profile    profiles\FinnishSchedulingPractitioner.fsh
FinnishSchedulingPractitionerRole   	Profile    profiles\FinnishSchedulingPractitionerRole.fsh
FinnishSchedulingSchedule           	Profile    profiles\FinnishSchedulingSchedule.fsh
FinnishSchedulingSlot               	Profile    profiles\FinnishSchedulingSlot.fsh
HomeMunicipalityExtension           	Extension  extensions\HomeMunicipalityExtension.fsh
MiscAppointmentDataExtension        	Extension  extensions\MiscAppointmentDataExtension.fsh
NotificationMediumExtension         	Extension  extensions\NotificationMediumExtension.fsh
ParentAppointment                   	Extension  extensions\ParentAppointment.fsh
PatientInstructionURLExtension      	Extension  extensions\PatientInstructionURLExtension.fsh
PractitionerGenderExtension         	Extension  extensions\PractitionerGenderExtension.fsh
QueueNoExtension                    	Extension  extensions\QueueNoExtension.fsh
ReferralIdExtension                 	Extension  extensions\ReferralIdExtension.fsh
RequestedServiceExtension           	Extension  extensions\RequestedServiceExtension.fsh
ResourceCalendarIdExtension         	Extension  extensions\ResourceCalendarIdExtension.fsh
SelfServiceExtension                	Extension  extensions\SelfServiceExtension.fsh
ServiceEventExtension               	Extension  extensions\ServiceEventExtension.fsh
TicketNoExtension                   	Extension  extensions\TicketNoExtension.fsh
TopicIdExtension                    	Extension  extensions\TopicIdExtension.fsh
VisibleToCustodianExtension         	Extension  extensions\VisibleToCustodianExtension.fsh
finnishcodeset                      	Mapping    mappings\finnishcodeset.fsh